Tiles:

1: W,img/testtile.bmp
2: BL,img/testdiagtile.bmp
3: BR,img/testdiagtile.bmp
4: TL,img/testdiagtile.bmp
5: TR,img/testdiagtile.bmp

Entities:

p: PlayerSpawn
e: Enemy1

Room 1:

1,1,1,1,1,1,1,1,1,1,1,1,c,1,1,1,1,1,1,1,1,1,1,1,1,1,1,1,1,1
1,4, , , , , , , , , , , , , , , , , , , , , , , , , , ,5,1
1, , , , , , , , , , , , , , , , , , , , , , , , , , , , ,1
1, , , , , , , , , , , , , , , , , , , , , , , , , , , , ,1
1, , , , , , , , , , , , , , , , , , , , , , , , , , , , ,1
1, , , , , , , , , , , , , , , , , , , , , , , , , , , , ,1
d, , , , , , , , , , , , , , , , , , , , , , , , , , , , ,a
1, , , , , , , , , , , , , , , , , , , , , , , , , , , , ,1
1, , , , , , , , , , , , , ,p,e, , , , , , , , , , , , , ,1
1, , , , , , , , , , , , , , , , , , , , , , , , , , , , ,1
1, , , , , , , , , , , , , , , , , , , , , , , , , , , , ,1
1, , , , , , , , , , , , , , , , , , , , , , , , , , , , ,1
1, , , , , , , , , , , , , , , , , , , , , , , , , , , , ,1
1, , , , , , , , , , , , , , , , , , , , , , , , , , , , ,1
1, , , , , , , , , , , , , , , , , , , , , , , , , , , , ,1
1,2, , , , , , , , , , , , , , , , , , , , , , , , , , ,3,1
1,1,1,1,1,1,1,1,1,1,1,1,b,1,1,1,1,1,1,1,1,1,1,1,1,1,1,1,1,1

Doors:

a: 3,a,Right,4
b: 2,a,Down,4
c: 4,a,Up,4
d: 5,a,Left,4

Room 2:

1,1,1,1,1,1,1,1,1,1,1,1,a,1,1,1,1,1,1,1,1,1,1,1,1,1,1,1,1,1
1, , , , , , , , , , , , , , , , , , , , , , , , , , , , ,1
1, , , , , , , , , , , , , , , , , , , , , , , , , , , , ,1
1, , , , , , , , , , , , , , , , , , , , , , , , , , , , ,1
1, , , , , , , , , , , , , , , , , , , , , , , , , , , , ,1
1, , , , , , , , , , , , , , , , , , , , , , , , , , , , ,1
1, , , , , , , , , , , , , , , , , , , , , , , , , , , , ,1
1, , , , , , , , , , , , , , , , , , , , , , , , , , , , ,1
1, , , , , , , , , , , , ,3,2, , , , , , , , , , , , , , ,1
1, , , , , , , , , , , , ,5,4, , , , , , , , , , , , , , ,1
1, , , , , , , , , , , , , , , , , , , , , , , , , , , , ,1
1, , , , , , , , ,e, , , , , , , , , ,e, , , , , , , , , ,1
1, , , , , , , , , , , , , , , , , , , , , , , , , , , , ,1
1, , , , , , , , , , , , , , , , , , , , , , , , , , , , ,1
1, , , , , , , , , , , , , , , , , , , , , , , , , , , , ,1
1, , , , , , , , , , , , , , , , , , , , , , , , , , , , ,1
1,1,1,1,1,1,1,1,1,1,1,1,1,1,1,1,1,1,1,1,1,1,1,1,1,1,1,1,1,1

Doors:

a:

Room 3:

1,1,1,1,1,1,1,1,1,1,1,1,1,1,1,1,1
1, , , , , , , , , , , , , , , ,1
1, , , , , , , , , , , , , , , ,1
1, , , , , , , , , , , , , , , ,1
1, , , , , ,e,e,e,e, , , , , , ,1
1, , , , , , , , , , , , , , , ,1
1, , , , , , , , , , , , , , , ,1
1, , , , , , , , , , , , , , , ,1
1, , , , , , , , , , , , , , , ,1
1, , , , , , , , , , , , , , , ,1
1, , , , , , , , , , , , , , , ,1
a, , , , , , , , , , , , , , , ,1
1, , , , , , , , , , , , , , , ,1
1, , , , , , , , , , , , , , , ,1
1, , , , , , , , , , , , , , , ,1
1, , , , , , , , , , , , , , , ,1
1,1,1,1,1,1,1,1,1,1,1,1,1,1,1,1,1

Doors:

a:

Room 4:

1,1,1,1,1,b,1,1,1,1,1,1,1,1
1, , , , , , , , , , , , ,1
1, , , , , , , , , , , , ,1
1, , , , , , , , , , , , ,1
1, , , , , , , , , , , , ,1
1, , , , , , , , , , , , ,1
1, , , , , , , , , , , , ,1
1, , , , , , , , , , , , ,1
1, , , , , , , , , , , , ,1
1, , , , , , , , , , , , ,1
1, , , , , , , , , , , , ,1
1, , , , , , , , , , , , ,1
1, , , , , , , , , , , , ,1
1, , , , , , , , , , , , ,1
1, , , , , , , , , , , , ,1
1, , , , , , , , , , , , ,1
1, , , , , , , , , , , , ,1
1, , , , , , , , , , , , ,1
1, , , , , , , , , , , , ,1
1, , , , , , , , , , , , ,1
1, , , , , , , , , , , , ,1
1, , , , , , , , , , , , ,1
1, , , , , , , , , , , , ,1
1, , , , , , , , , , , , ,1
1, , , , , , , , , , , , ,1
1, , , , , , , , , , , , ,1
1, , , , , , , , , , , , ,1
1, , , , , , , , , , , , ,1
1, , , , , , , , , , , , ,1
1, , , , , , , , , , , , ,1
1, , , , , , , , , , , , ,1
1, , , , , , , , , , , , ,1
1, , , , , , , , , , , , ,1
1, , , , , , , , , , , , ,1
1, , , , , , , , , , , , ,1
1, , , , , , , , , , , , ,1
1,1,1,1,1,a,1,1,1,1,1,1,1,1

Doors:

a:
b: 6,q,Up,4

Room 6:

1,1,1,1,1,1,1,1,1,1,1,1,1,1,1,1,1,1,1,1,1,1
1, , , , , , , , , , , , , , , , , , , , ,1
1, , , , , , , , , , , , , , , , , , , , ,1
1, , , , , , , , , , , , , , , , , , , , ,1
1, , , , , , , , , , , , , , , , , , , , ,1
1, , , , , , , , , , , , , , , , , , , , ,1
1, , , , , , , , , , , , , , , , , , , , ,1
1, , , , , , , , , , , , , , , , , , , , ,1
1, , , , , , , , ,e, ,e, , , , , , , , , ,1
1, , , , , , , , , , , , , , , , , , , , ,1
1, , , , , , , , , , , , , , , , , , , , ,1
1, , , , , , , , , , , , , , , , , , , , ,1
1, , , , , , , , , , , , , , , , , , , , ,1
1, , , , , , , , , , , , , , , , , , , , ,1
1, , , , , , , , , , , , , , , , , , , , ,1
1, , , , , , , , , , , , , , , , , , , , ,1
1, , , , , , , , , , , , , , , , , , , , ,1
1,1,1,1,1,1,1,1,1,q,1,1,1,1,1,1,1,1,1,1,1,1

Doors:

q:

Room 5:

 , , , , , , , , , , , ,1,1,1,1,1,1,1,1,1,1,1,1,1,1,1,1,1, , , , , , , , , , , 
 , , , , , , , , , , ,1,4, , , , , , , , , , , , , , , ,5,1, , , , , , , , , , 
 , , , , , , , , , ,1,4, , , , , , , , , , , , , , , , , ,5,1, , , , , , , , , 
 , , , , , , , , ,1,4, , , , , , , , , ,e, , , , , , , , , ,5,1, , , , , , , , 
 , , , , , , , ,1,4, , , , , , , , , , , , , , , , , , , , , ,5,1, , , , , , , 
 , , , , , , ,1,4, , , , , , , , , , , , , , , , , , , , , , , ,5,1, , , , , , 
 , , , , , ,1,4, , , , , , , , , , , , , , , , , , , , , , , , , ,5,1, , , , , 
 , , , , ,1,4, , , , , , , ,e, , , , , , , , , , , , , , , , , , , ,5,1, , , , 
 , , , ,1,4, , , , , , , , , , , , , , , , , , , , , , , , , , , , , ,5,1, , , 
 , , ,1,4, , , , , , , , , , , , , , , , , , , , , , , , , , , , , , , ,5,1, , 
 , ,1,4, , , , , , , , , , , , , , , , , , , , , , , , , , , , , , , , , ,5,1, 
 ,1,4, , , , , , , , , , , , , , , , , , , , , , , , , , , , , , , , , , , ,5,1
1,4, , , , , , , , , , , , , , , , , , , , , , , , , , , , , , , , , , , , , ,1
1, , , , , , , , , , , , , , , , , , , , , , , , , , , , , , , , , , , , , , ,1
1, , , , , , , , , , , , , , , , , , , , , , , , , , , , , , , , , , , , , , ,1
1, , , , , , , , , , , , , , , , , , , , , , , , , , , , , , , , , , , , , , ,1
1, , , , , , ,e, , , , , , , , , , , , , , , , , , , , , , , , , , , , , , , ,a
1, , , , , , , , , , , , , , , , , , , , , , , , , , , , , , , , , , , , , , ,1
1,2, , , , , , , , , , , , , , , , , , , , , , , , , , , , , , , , , , , , , ,1
 ,1,2, , , , , , , , , , , , , , , , , , , , , , , , , , , , , , , , , , , , ,1
 , ,1,2, , , , , , ,e, , , , , , , , , , , , , , , , , , , , , , , , , , , , ,1
 , , ,1,2, , , , , , , , , , ,3,2, , , , , , , , , , , , , , , , , , , , , , ,1
 , , , ,1,2, , , , , , , , ,3,1,1,2, , , , , , , , , , , , , , , , , , , , , ,1
 , , , , ,1,2, , , , , , ,3,1, , ,1,2, , , , , , , , , , , , , , , , , , , , ,1
 , , , , , ,1,2, , , , ,3,1, , , , ,1,2, , , ,e, , , , , , , , , , , , , , , ,1
 , , , , , , ,1,2, , ,3,1, , , , , , ,1,2, , , , , , , , , , , ,3,2, , , , , ,1
 , , , , , , , ,1,2,3,1, , , , , , , , ,1,2, , , , , , , , , ,3,1,1,2, , , ,3,1
 , , , , , , , , , , , , , , , , , , , , ,1,1,1,1,1,1,1,1,1,1,1, , ,1,1,1,1,1,1

Doors:

a: